SO ./textures/flower1_1.png
NO ./textures/flower2.png
EA ./textures/flower3.png
WE ./textures/flower4.png
C   16,203,212
F   24,175,76


111111111111
100000000001
100010011101
10010001 101
10100N011101
100000000001
111111111111