SO ./textures/flower1_1.png
NO ./textures/flower2.png
EA ./textures/flower3.png
WE ./textures/flower4.png
C   16,203,212
F   24,175,76


11111111111111111111111111111111111111111
10001111111111111111111111111111111111111
10101111111111111111111111111111111111111
1N001111111111111111111111111111111111111
11111111111111111111111111111111111111111