SO        ./textures/south.png
NO   ./textures/north.png
EA                                                ./textures/east.png
WE              ./textures/west.png
C   225,30,0
F220,100,0



1111111
1110111
1110111
1110111
1110111
1110111
1001001
100N001
1000001
1111111