SO        ./textures/south.xpm42
NO   ./textures/north.xpm42
EA                                                ./textures/east.xpm42
WE              ./textures/west.xpm42
C   225,30,0
F220,100,0

11111111111111111111111111111111111111111
10001111111111111111111111111111111111111
10101111111111111111111111111111111111111
1N001111111111111111111111111111111111111
11111111111111111111111111111111111111111