SO ./textures/flower1_1.png
NO ./textures/flower2.png
EA ./textures/flower3.png
WE ./textures/flower4.png
C   0,175,1
F   24,25,123



11111111111
10000000001
10000100001
10100000101
10010001001
10000N00001
10010001001
10100000101
10000100001
10000000001
11111111111
