SO ./textures/flower1_1.png
NO ./textures/flower2.png
EA ./textures/flower3.png
WE ./textures/flower4.png
C   16,203,212
F   24,175,76




11111111111
10000000001
10100100101
10010001001
10000000001
10100N00101
10000000001
10010001001
10100100101
10000000001
11111111111