SO ./textures/south.xpm42
NO ./textures/north.xpm42
EA ./textures/east.xpm42
WE ./textures/west.xpm42
C 200,200,200
F 100,100,100



1111111
1110111
1110111
1110111
1110111
1110111
1110111
1110111
1110111
1110111
1110111
1110111
1110111
1110111
1110111
1110111
1110111
1110111
1110111
1110111
1110111
1110111
1110111
1110111
1110111
1110111
1110111
1110111
1110111
1110111
1110111
1110111
1110111
1110111
1110111
1110111
1110111
1000001
100N001
1000001
1111111