F 124,224,97
C 97,197,224
SO ./textures/south.png
NO ./textures/north.png
EA ./textures/east.png
WE ./textures/west.png

        1111111111111111111111111
        1000000000110000000000001
        1011000001110000000000001
        1001000000000000000000001
111111111011000001110000000000111
100000000011000001110111111111111
11110111111111011100000010001
1111011111111101110101001001
11000000110101011100000010001
10000000000000001100000010001
10000000000000001101010010001
11000001110101011111011110S0111
11110111 1110101 101111010001
11111111 1111111 111111111111