SO ./textures/matrix.png
NO ./textures/matrix.png
EA ./textures/matrix.png
WE ./textures/matrix.png
C 225,30,0
F 220,100,0


1111111
1000001
1010001

1000N01
1111111